                                                                                                                                                          
     ,--.   ,---.   ,--.   ,--.   ,---.     ,--.  ,--. ,------.   ,---. ,------.  ,--------.    ,---.   ,------. ,------.  ,--.   ,--. ,------. ,------.  
     |  |  /  O  \   \  `.'  /   /  O  \    |  '--'  | |  .---'  /    | |  .--. ' '--.  .--'   '   .-'  |  .---' |  .--. '  \  `.'  /  |  .---' |  .--. ' 
,--. |  | |  .-.  |   \     /   |  .-.  |   |  .--.  | |  `--,  /  '  | |  '--'.'    |  |      `.  `-.  |  `--,  |  '--'.'   \     /   |  `--,  |  '--'.' 
|  '-'  / |  | |  |    \   /    |  | |  |   |  |  |  | |  `---. '--|  | |  |\  \     |  |      .-'    | |  `---. |  |\  \     \   /    |  `---. |  |\  \  
 `-----'  `--' `--'     `-'     `--' `--'   `--'  `--' `------'    `--' `--' '--'    `--'      `-----'  `------' `--' '--'     `-'     `------' `--' '--' 
                                                                                                                                                          
${HE4RT_TITLE} ${HE4RT_SERVER_VERSION}
Powered by ${HE4RT_AUTOR}